00000000000010000000
00001100111110001000
00001100000000001000
00000001100000001000
00000001100110001000
00110000000110001000
00110000000000001000
00000000000000001000
00000001111101001020
00000001000001000000