00000000010000011111
00001100010000001010
11001100000011011111
11000000100000001110
00000111100000000100
00100000100000001110
01110000001110000100
11111000001000000000
01010000100000000000
11111000100000000002