00000000111110111111
01111110111110111111
01110000000000001111
01110111111111100000
01110111111111101110
00000000000111101110
01011110110000001110
01011110110111101110
01011110110111101110
01000000110002000000