00000000000000000000
01010101010101010101
00000000000000000000
01010101010101010101
00000000000000000000
01010101010101010101
00000000000000000000
01010101010101010101
00000000000000000200
01010101010101010101