00000000000000000000
01110001111110001110
01000000000000000010
00011110011001111000
01011000000000011010
01011000002000011010
00011110011001111000
01000000000000000010
01110001111110001110
00000000000000000000