00000000001102000010
00011111000111100110
00100100000000010100
00100100100101110000
01100000000101000010
00000010110101000110
00000000011100010100
01001001100011110111
01111000000000000001
00000000111110000001