00000000001110002000
01111111000010000000
00000100000011110000
11000100111110000000
00000100000010000000
00111110011110011100
00000000000000001000
01111001111111101000
00001000000000001000
00001111111000000000