00011111110000000000
00000000000111111001
00011111110000010001
00010101010011010001
00000000000000000000
00101010101001111011
00101010100001000001
00101010000001020001
00101000000001000001
00100000000001111111