00000000000000000000
01111111111000000100
00001000000000111100
00001000000000000100
01111111100011111100
01000100000010002000
01000100000000000000
01000000011111010111
00000101110010010000
01111100010000010000