01111111000000000010
00000001011100111010
01111100010000000010
01111111111011011010
00000000001010101010
11001111101000001010
01101000101111111010
00001111101000000010
10000200001101111110
11101111111000000000