00000100000000000010
11100001010100000010
00000101010111111001
00000101010100000000
00100000000001010100
00101110020011010101
00100000000001000000
01110111000101111011
00100101000100101010
00000001000100000000