00000001010101010101
01010100000001010101
01010101010100000001
01010101010101010100
00000001010101010101
01010100002001010101
01010101010100000001
01010101010101010100
00000001010101010101
01010100000001010101