01111111000000111111
00000000101100000000
01110111100111110000
00000000000100000010
01111110000001000010
00001000000111000010
00001000000000000010
10100001111000000010
00100200000001000010
00100000001111001110