00000011110001111111
01111000000100000100
00000000000100111100
01111111000100100000
00000000000000000000
01111111101100011111
00000000000001000000
00111111000001001000
00000001002001001111
00000001000001000000