00111111111111111011
00000000000010000010
01001111111111100100
00101000100000001110
00100001111110000000
00111101001000111110
00001000011000000000
01101011210111111100
00000000000000100010
00101010101010001000