00010101010100000000
01000010000000000000
01010101010100000000
01000000100000000000
01001010101010000200
01000000010000000000
01001010101011000000
01000010000000000000
01010101010100000000
00000000001000000000