00011000000010001111
00010011100010000000
11010000000010000000
00000000000011111210
01000100000000010010
01000101110000011110
00000100010001110000
01111100010001000000
10000000011101111100
11100000000000000000