00100000000000000111
00111000000100000100
10000000111100011100
10000001000100010000
11100111000111010100
00100000000000000100
00111000110000111100
00001000021000100011
00001000011000100001
11111111110000000111