00000000000001000011
01000000111101010001
01001110100000010001
01110100000111110000
00000111111100000110
11100100010000000010
10100100010000110010
10110000011100121110
00000000000100100000
00000000000011100000